NO textures/simonkraft/wet_sponge.xpm
SO textures/simonkraft/wet_sponge.xpm
WE textures/simonkraft/wet_sponge.xpm
EA textures/simonkraft/wet_sponge.xpm

F 164,169,20
C 153,204,255

111111111 11111111111
101000001 10000000001
101010101 11111110001
100000101 10000010001
1111N0101 11101011101
100000101 10101000001
111111111 11111111111
