NO textures/simonkraft/wet_sponge.xpm
SO textures/simonkraft/wet_sponge.xpm
WE textures/simonkraft/wet_sponge.xpm
EA textures/simonkraft/wet_sponge.xpm

F 164,169,20
C 153,204,255

      111 11111 11111
      1100 00001 1001
111111111111111111111
101 10101 11111110001111
101 10101 100 0010011
111 1N101 11101011101
100 00101 10101000001
111 11111 11111111111

